Completed Date ; Description ; Paid Out (GBP) ; Paid In (GBP) ; Exchange Out; Exchange In; Balance (GBP); Category; Notes
2 Nov 2020 ; sanebox Inc. FX Rate £1 = $1.2821 ; 5.46 ;  ;  USD 7.00 ;  ; 301.23; Shopping; 
31 Oct 2020 ; Top-Up by *8018  ;  ; 200.00 ;  ;  ; 306.69; General; 
30 Oct 2020 ; Audible Ltd  ; 7.99 ;  ;  ;  ; 106.69; Shopping; 
29 Oct 2020 ; Chiringuito "PACO" FX Rate £1 = €1.1039 ; 38.05 ;  ;  EUR 42.00 ;  ; 114.68; Restaurants; 
29 Oct 2020 ; Playa de la Rada FX Rate £1 = €1.1033 ; 40.79 ;  ;  EUR 45.00 ;  ; 152.73; Transport; 
29 Oct 2020 ; itunes.com/bill  ; 4.99 ;  ;  ;  ; 193.52; Shopping; 
28 Oct 2020 ; Amazon FX Rate £1 = €1.1028 ; 158.95 ;  ;  EUR 175.29 ;  ; 198.51; Shopping; 
28 Oct 2020 ; Experian Ltd  ; 14.99 ;  ;  ;  ; 357.46; General; 
27 Oct 2020 ; Gym junkie FX Rate £1 = €1.1048 ; 5.44 ;  ;  EUR 6.00 ;  ; 372.45; Restaurants; 
27 Oct 2020 ; Rest Pizzeria Canela FX Rate £1 = €1.1015 ; 23.61 ;  ;  EUR 26.00 ;  ; 377.89; Restaurants; 
27 Oct 2020 ; Autopista del Sol FX Rate £1 = €1.0884 ; 1.89 ;  ;  EUR 2.05 ;  ; 401.50; Transport; 
26 Oct 2020 ; Top-Up by *8018  ;  ; 200.00 ;  ;  ; 403.39; General; 
26 Oct 2020 ; Three  ; 20.00 ;  ;  ;  ; 203.39; Services; 
25 Oct 2020 ; Top-Up by *8018  ;  ; 200.00 ;  ;  ; 223.39; General; 
24 Oct 2020 ; Gpv Benahavis FX Rate £1 = €1.1026 ; 8.56 ;  ;  EUR 9.43 ;  ; 23.39; Transport; 
24 Oct 2020 ; Reebok Hybrid FX Rate £1 = €1.1057 ; 5.43 ;  ;  EUR 6.00 ;  ; 31.95; Health; 
20 Oct 2020 ; Reebok Hybrid FX Rate £1 = €1.1019 ; 5.45 ;  ;  EUR 6.00 ;  ; 37.38; Health; 
19 Oct 2020 ; Itunes  ; 0.79 ;  ;  ;  ; 42.83; Shopping; 
19 Oct 2020 ; Amazon FX Rate £1 = €1.0902 ; 18.83 ;  ;  EUR 20.52 ;  ; 43.62; Shopping; 
19 Oct 2020 ; South Cafe FX Rate £1 = €1.0902 ; 57.79 ;  ;  EUR 63.00 ;  ; 62.45; Restaurants; 
18 Oct 2020 ; Banus Marina Mall FX Rate £1 = €1.0902 ; 31.14 ;  ;  EUR 33.95 ;  ; 120.24; Shopping; 
18 Oct 2020 ; Gym junkie FX Rate £1 = €1.0902 ; 8.26 ;  ;  EUR 9.00 ;  ; 151.38; Restaurants; 
18 Oct 2020 ; Mini India Diana - Indian Restaurant Diana FX Rate £1 = €1.0902 ; 25.50 ;  ;  EUR 27.80 ;  ; 159.64; Restaurants; 
18 Oct 2020 ; Parking CC Marina Banús FX Rate £1 = €1.0902 ; 4.50 ;  ;  EUR 4.90 ;  ; 185.14; Transport; 
18 Oct 2020 ; El Corte Ingles Marbella FX Rate £1 = €1.0902 ; 96.17 ;  ;  EUR 104.85 ;  ; 189.64; Shopping; 
18 Oct 2020 ; El Corte Ingles Marbella FX Rate £1 = €1.0902 ; 27.47 ;  ;  EUR 29.95 ;  ; 285.81; Shopping; 
17 Oct 2020 ; Top-Up by *8018  ;  ; 200.00 ;  ;  ; 313.28; General; 
15 Oct 2020 ; Gym junkie FX Rate £1 = €1.0979 ; 5.47 ;  ;  EUR 6.00 ;  ; 113.28; Restaurants; 
15 Oct 2020 ; Diana-costaspine FX Rate £1 = €1.1040 ; 36.24 ;  ;  EUR 40.00 ;  ; 118.75; Health; 
14 Oct 2020 ; Hustle n' Flow Eatery FX Rate £1 = €1.1064 ; 37.06 ;  ;  EUR 41.00 ;  ; 154.99; Restaurants; 
13 Oct 2020 ; Amazon FX Rate £1 = €1.1055 ; 41.59 ;  ;  EUR 45.98 ;  ; 192.05; Shopping; 
13 Oct 2020 ; Gym junkie FX Rate £1 = €1.1036 ; 46.22 ;  ;  EUR 51.00 ;  ; 233.64; Restaurants; 
13 Oct 2020 ; Overseas Guadalmina FX Rate £1 = €1.1031 ; 4.08 ;  ;  EUR 4.50 ;  ; 279.86; Groceries; 
12 Oct 2020 ; Top-Up by *8018  ;  ; 200.00 ;  ;  ; 283.94; General; 
12 Oct 2020 ; Sumup  *hustle Everyday FX Rate £1 = €1.0913 ; 7.79 ;  ;  EUR 8.50 ;  ; 83.94; Restaurants; 
11 Oct 2020 ; Reebok Hybrid FX Rate £1 = €1.0913 ; 5.50 ;  ;  EUR 6.00 ;  ; 91.73; Health; 
11 Oct 2020 ; E.s. Calypso FX Rate £1 = €1.0913 ; 41.24 ;  ;  EUR 45.00 ;  ; 97.23; Transport; 
11 Oct 2020 ; Gpv Benahavis FX Rate £1 = €1.0913 ; 13.92 ;  ;  EUR 15.19 ;  ; 138.47; Transport; 
9 Oct 2020 ; Exchange GBP to  FX Rate £1 = €1.0992 ; 31.84 ;  ;  GBP 31.84 ;  ; 152.39; General; 
9 Oct 2020 ; Amazon Prime  ; 7.99 ;  ;  ;  ; 184.23; Shopping; 
9 Oct 2020 ; Diana-costaspine FX Rate £1 = €1.0936 ; 36.58 ;  ;  EUR 40.00 ;  ; 192.22; Health; 
9 Oct 2020 ; La Bodega del Mar FX Rate £1 = €1.0990 ; 55.87 ;  ;  EUR 61.40 ;  ; 228.80; Health; 
9 Oct 2020 ; Premium plan fee  ; 72.00 ;  ;  ;  ; 284.67; General; 
8 Oct 2020 ; Talleres San Pedro FX Rate £1 = €1.0982 ; 91.06 ;  ;  EUR 100.00 ;  ; 356.67; Transport; 
8 Oct 2020 ; Restaurante las Olas Beach FX Rate £1 = €1.1005 ; 93.59 ;  ;  EUR 103.00 ;  ; 447.73; Restaurants; 
8 Oct 2020 ; Parking Gourmet FX Rate £1 = €1.1022 ; 4.81 ;  ;  EUR 5.30 ;  ; 541.32; Transport; 
8 Oct 2020 ; The Bookshop FX Rate £1 = €1.0992 ; 25.29 ;  ;  EUR 27.80 ;  ; 546.13; Shopping; 
7 Oct 2020 ; Top-Up by *8018  ;  ; 400.00 ;  ;  ; 571.42; General; 
7 Oct 2020 ; Itunes  ; 5.99 ;  ;  ;  ; 171.42; Shopping; 
7 Oct 2020 ; Cafe 10 FX Rate £1 = €1.0918 ; 24.73 ;  ;  EUR 27.00 ;  ; 177.41; Restaurants; 
5 Oct 2020 ; Itunes  ; 2.99 ;  ;  ;  ; 202.14; Shopping; 
3 Oct 2020 ; Mini India Diana - Indian Restaurant Diana FX Rate £1 = €1.1035 ; 32.54 ;  ;  EUR 35.90 ;  ; 205.13; Restaurants; 
3 Oct 2020 ; Gpv Benahavis FX Rate £1 = €1.1006 ; 40.89 ;  ;  EUR 45.00 ;  ; 237.67; Transport; 
2 Oct 2020 ; Top-Up by *8018  ;  ; 200.00 ;  ;  ; 278.56; General; 
1 Oct 2020 ; What's Cooking? FX Rate £1 = €1.0969 ; 9.94 ;  ;  EUR 10.90 ;  ; 78.56; Restaurants; 
1 Oct 2020 ; Diana-costaspine FX Rate £1 = €1.0987 ; 36.41 ;  ;  EUR 40.00 ;  ; 88.50; Health; 
30 Sep 2020 ; Audible Ltd  ; 7.99 ;  ;  ;  ; 124.91; Shopping; 
29 Sep 2020 ; Wild Café & Restaurante FX Rate £1 = €1.0844 ; 53.49 ;  ;  EUR 58.00 ;  ; 132.90; Restaurants; 
29 Sep 2020 ; Mini India Diana - Indian Restaurant Diana FX Rate £1 = €1.0844 ; 28.41 ;  ;  EUR 30.80 ;  ; 186.39; Restaurants; 
28 Sep 2020 ; Experian Ltd  ; 14.99 ;  ;  ;  ; 214.80; General; 
28 Sep 2020 ; sanebox Inc. FX Rate £1 = $1.2760 ; 5.49 ;  ;  USD 7.00 ;  ; 229.79; Shopping; 
27 Sep 2020 ; Diana-costaspine FX Rate £1 = €1.0925 ; 36.62 ;  ;  EUR 40.00 ;  ; 235.28; Health; 
27 Sep 2020 ; Leanpub FX Rate £1 = $1.2715 ; 19.67 ;  ;  USD 25.00 ;  ; 271.90; Shopping; 
24 Sep 2020 ; La Bodega del Mar FX Rate £1 = €1.0859 ; 57.92 ;  ;  EUR 62.90 ;  ; 291.57; Health; 
24 Sep 2020 ; Three  ; 20.00 ;  ;  ;  ; 349.49; Services; 
24 Sep 2020 ; Top-Up by *8018  ;  ; 200.00 ;  ;  ; 369.49; General; 
23 Sep 2020 ; Chiropractic - Ricardo Ma FX Rate £1 = €1.0871 ; 46.00 ;  ;  EUR 50.00 ;  ; 169.49; Health; 
23 Sep 2020 ; Amazon FX Rate £1 = €1.0799 ; 18.66 ;  ;  EUR 20.15 ;  ; 215.49; Shopping; 
23 Sep 2020 ; Reebok Hybrid FX Rate £1 = €1.0873 ; 5.52 ;  ;  EUR 6.00 ;  ; 234.15; Health; 
22 Sep 2020 ; Sidreria Usategui FX Rate £1 = €1.0799 ; 59.27 ;  ;  EUR 64.00 ;  ; 239.67; Restaurants; 
21 Sep 2020 ; Hustle n' Flow Eatery FX Rate £1 = €1.0799 ; 55.56 ;  ;  EUR 60.00 ;  ; 298.94; Restaurants; 
21 Sep 2020 ; Amazon FX Rate £1 = €1.0939 ; 84.03 ;  ;  EUR 91.92 ;  ; 354.50; Shopping; 
21 Sep 2020 ; Amazon FX Rate £1 = €1.0943 ; 22.38 ;  ;  EUR 24.49 ;  ; 438.53; Shopping; 
21 Sep 2020 ; Itunes  ; 0.79 ;  ;  ;  ; 460.91; Shopping; 
21 Sep 2020 ; Reebok Hybrid FX Rate £1 = €1.0948 ; 5.49 ;  ;  EUR 6.00 ;  ; 461.70; Health; 
21 Sep 2020 ; Costajump San Pedro FX Rate £1 = €1.0923 ; 15.29 ;  ;  EUR 16.70 ;  ; 467.19; Entertainment; 
20 Sep 2020 ; Top-Up by *8018  ;  ; 200.00 ;  ;  ; 482.48; General; 
20 Sep 2020 ; Itunes  ; 9.99 ;  ;  ;  ; 282.48; Shopping; 
20 Sep 2020 ; Gym junkie FX Rate £1 = €1.0923 ; 33.88 ;  ;  EUR 37.00 ;  ; 292.47; Restaurants; 
20 Sep 2020 ; Gym junkie FX Rate £1 = €1.0875 ; 7.82 ;  ;  EUR 8.50 ;  ; 326.35; Restaurants; 
18 Sep 2020 ; Reebok Hybrid FX Rate £1 = €1.0987 ; 5.47 ;  ;  EUR 6.00 ;  ; 334.17; Health; 
18 Sep 2020 ; Chiropractic - Ricardo Ma FX Rate £1 = €1.0992 ; 36.39 ;  ;  EUR 40.00 ;  ; 339.64; Health; 
18 Sep 2020 ; Supersol Su FX Rate £1 = €1.0990 ; 9.31 ;  ;  EUR 10.23 ;  ; 376.03; Groceries; 
18 Sep 2020 ; Reebok Hybrid FX Rate £1 = €1.0831 ; 5.54 ;  ;  EUR 6.00 ;  ; 385.34; Health; 
18 Sep 2020 ; Autopista del Sol FX Rate £1 = €1.0685 ; 3.14 ;  ;  EUR 3.35 ;  ; 390.88; Transport; 
18 Sep 2020 ; San Pedro Del Mar FX Rate £1 = €1.0827 ; 46.52 ;  ;  EUR 50.37 ;  ; 394.02; Transport; 
18 Sep 2020 ; Autopista del Sol FX Rate £1 = €1.0685 ; 3.14 ;  ;  EUR 3.35 ;  ; 440.54; Transport; 
17 Sep 2020 ; Amazon FX Rate £1 = €1.0841 ; 7.47 ;  ;  EUR 8.09 ;  ; 443.68; Shopping; 
17 Sep 2020 ; Comidas Andyan s.l. FX Rate £1 = €1.0685 ; 23.40 ;  ;  EUR 25.00 ;  ; 451.15; Restaurants; 
17 Sep 2020 ; Top-Up by *8018  ;  ; 200.00 ;  ;  ; 474.55; General; 
14 Sep 2020 ; Payment from Rose Ajw  ;  ; 200.00 ;  ;  ; 274.55; General; TO REVOLUT -LYGU-
14 Sep 2020 ; Three  ; 20.00 ;  ;  ;  ; 74.55; Services; 
14 Sep 2020 ; Gym junkie FX Rate £1 = €1.0685 ; 49.61 ;  ;  EUR 53.00 ;  ; 94.55; Restaurants; 
14 Sep 2020 ; Parking El Corte Inglés Serrano FX Rate £1 = €1.0685 ; 2.20 ;  ;  EUR 2.35 ;  ; 144.16; Transport; 
14 Sep 2020 ; Gpv Benahavis FX Rate £1 = €1.0685 ; 9.17 ;  ;  EUR 9.79 ;  ; 146.36; Transport; 
13 Sep 2020 ; Reebok Hybrid FX Rate £1 = €1.0834 ; 5.54 ;  ;  EUR 6.00 ;  ; 155.53; Health; 
11 Sep 2020 ; Itunes  ; 7.99 ;  ;  ;  ; 161.07; Shopping; 
11 Sep 2020 ; Autopista del Sol FX Rate £1 = €1.1089 ; 3.03 ;  ;  EUR 3.35 ;  ; 169.06; Transport; 
11 Sep 2020 ; Autopista del Sol FX Rate £1 = €1.1089 ; 3.03 ;  ;  EUR 3.35 ;  ; 172.09; Transport; 
11 Sep 2020 ; Gym junkie FX Rate £1 = €1.0996 ; 9.10 ;  ;  EUR 10.00 ;  ; 175.12; Restaurants; 
11 Sep 2020 ; Gpv Benahavis FX Rate £1 = €1.1004 ; 21.71 ;  ;  EUR 23.89 ;  ; 184.22; Transport; 
9 Sep 2020 ; Amazon Prime  ; 7.99 ;  ;  ;  ; 205.93; Shopping; 
9 Sep 2020 ; Reebok Hybrid FX Rate £1 = €1.1145 ; 5.39 ;  ;  EUR 6.00 ;  ; 213.92; Health; 
8 Sep 2020 ; ALDI FX Rate £1 = €1.1089 ; 50.18 ;  ;  EUR 55.64 ;  ; 219.31; Groceries; 
7 Sep 2020 ; itunes.com/bill  ; 5.99 ;  ;  ;  ; 269.49; Shopping; 
5 Sep 2020 ; Reebok Hybrid FX Rate £1 = €1.1221 ; 5.35 ;  ;  EUR 6.00 ;  ; 275.48; Health; 
5 Sep 2020 ; Payment from Rose Ajw  ;  ; 200.00 ;  ;  ; 280.83; General; TO REVOLUT -D8UG-
3 Sep 2020 ; Gym junkie FX Rate £1 = €1.1235 ; 44.51 ;  ;  EUR 50.00 ;  ; 80.83; Restaurants; 
3 Sep 2020 ; Reebok Hybrid FX Rate £1 = €1.1203 ; 5.36 ;  ;  EUR 6.00 ;  ; 125.34; Health; 
3 Sep 2020 ; San Pedro Del Mar FX Rate £1 = €1.1188 ; 40.33 ;  ;  EUR 45.12 ;  ; 130.70; Transport; 
2 Sep 2020 ; Parking El Corte Inglés Serrano FX Rate £1 = €1.1158 ; 1.62 ;  ;  EUR 1.80 ;  ; 171.03; Transport; 
2 Sep 2020 ; El Corte Ingles Marbella FX Rate £1 = €1.1155 ; 2.25 ;  ;  EUR 2.50 ;  ; 172.65; Shopping; 
2 Sep 2020 ; Organic With Love (OWL) FX Rate £1 = €1.1185 ; 10.73 ;  ;  EUR 12.00 ;  ; 174.90; Shopping; 
1 Sep 2020 ; Audible Ltd  ; 7.99 ;  ;  ;  ; 185.63; Shopping; 
1 Sep 2020 ; El Piave FX Rate £1 = €1.1102 ; 41.98 ;  ;  EUR 46.60 ;  ; 193.62; Groceries; 
31 Aug 2020 ; Gpv Benahavis FX Rate £1 = €1.1102 ; 13.28 ;  ;  EUR 14.74 ;  ; 235.60; Transport; 
31 Aug 2020 ; Cinemas Teatro Goya FX Rate £1 = €1.1102 ; 4.60 ;  ;  EUR 5.10 ;  ; 248.88; Shopping; 
31 Aug 2020 ; Parking Arias Maldonado FX Rate £1 = €1.1102 ; 14.06 ;  ;  EUR 15.60 ;  ; 253.48; Transport; 
31 Aug 2020 ; El Corte Ingles Marbella FX Rate £1 = €1.1102 ; 2.53 ;  ;  EUR 2.80 ;  ; 267.54; Shopping; 
30 Aug 2020 ; Teatro Goya Cines Marbell FX Rate £1 = €1.1102 ; 16.04 ;  ;  EUR 17.80 ;  ; 270.07; Shopping; 
30 Aug 2020 ; Gpv Benahavis FX Rate £1 = €1.1102 ; 3.61 ;  ;  EUR 4.00 ;  ; 286.11; Transport; 
29 Aug 2020 ; Restaurante las Olas Beach FX Rate £1 = €1.1172 ; 85.04 ;  ;  EUR 95.00 ;  ; 289.72; Restaurants; 
29 Aug 2020 ; Licuas. S.a.-orquidario D FX Rate £1 = €1.1161 ; 5.38 ;  ;  EUR 6.00 ;  ; 374.76; Entertainment; 
29 Aug 2020 ; Parking CC Marina Banús FX Rate £1 = €1.1168 ; 2.33 ;  ;  EUR 2.60 ;  ; 380.14; Transport; 
28 Aug 2020 ; Itunes  ; 9.99 ;  ;  ;  ; 382.47; Shopping; 
28 Aug 2020 ; Three  ; 20.00 ;  ;  ;  ; 392.46; Services; 
28 Aug 2020 ; Reebok Hybrid FX Rate £1 = €1.1077 ; 5.42 ;  ;  EUR 6.00 ;  ; 412.46; Health; 
27 Aug 2020 ; Top-Up by *8018  ;  ; 200.00 ;  ;  ; 417.88; General; 
27 Aug 2020 ; Experian Ltd  ; 14.99 ;  ;  ;  ; 217.88; General; 
26 Aug 2020 ; Amazon FX Rate £1 = €1.1089 ; 18.93 ;  ;  EUR 20.99 ;  ; 232.87; Shopping; 
26 Aug 2020 ; sanebox Inc. FX Rate £1 = $1.3094 ; 5.35 ;  ;  USD 7.00 ;  ; 251.80; Shopping; 
25 Aug 2020 ; Top-Up by *8018  ;  ; 200.00 ;  ;  ; 257.15; General; 
25 Aug 2020 ; Hustle n' Flow Eatery FX Rate £1 = €1.1029 ; 48.96 ;  ;  EUR 54.00 ;  ; 57.15; Restaurants; 
24 Aug 2020 ; Maskom Supermercados FX Rate £1 = €1.1029 ; 8.84 ;  ;  EUR 9.75 ;  ; 106.11; Groceries; 
23 Aug 2020 ; Gym junkie FX Rate £1 = €1.1029 ; 10.88 ;  ;  EUR 12.00 ;  ; 114.95; Restaurants; 
23 Aug 2020 ; La Bodega del Mar FX Rate £1 = €1.1029 ; 11.93 ;  ;  EUR 13.15 ;  ; 125.83; Health; 
23 Aug 2020 ; Detalle Marbella FX Rate £1 = €1.1029 ; 8.93 ;  ;  EUR 9.84 ;  ; 137.76; Groceries; 
23 Aug 2020 ; Amazon FX Rate £1 = €1.1060 ; 22.17 ;  ;  EUR 24.52 ;  ; 146.69; Shopping; 
22 Aug 2020 ; Mini India Diana - Indian Restaurant Diana FX Rate £1 = €1.1100 ; 52.25 ;  ;  EUR 58.00 ;  ; 168.86; Restaurants; 
22 Aug 2020 ; Gym junkie FX Rate £1 = €1.1098 ; 46.86 ;  ;  EUR 52.00 ;  ; 221.11; Restaurants; 
21 Aug 2020 ; Autopista del Sol FX Rate £1 = €1.0995 ; 3.05 ;  ;  EUR 3.35 ;  ; 267.97; Transport; 
21 Aug 2020 ; Autopista del Sol FX Rate £1 = €1.0995 ; 3.05 ;  ;  EUR 3.35 ;  ; 271.02; Transport; 
21 Aug 2020 ; Itunes  ; 12.50 ;  ;  ;  ; 274.07; Shopping; 
21 Aug 2020 ; Itunes  ; 2.49 ;  ;  ;  ; 286.57; Shopping; 
21 Aug 2020 ; Itunes  ; 2.49 ;  ;  ;  ; 289.06; Shopping; 
20 Aug 2020 ; Top-Up by *8018  ;  ; 200.00 ;  ;  ; 291.55; General; 
19 Aug 2020 ; Itunes  ; 0.79 ;  ;  ;  ; 91.55; Shopping; 
19 Aug 2020 ; Reebok Hybrid FX Rate £1 = €1.1056 ; 5.43 ;  ;  EUR 6.00 ;  ; 92.34; Health; 
18 Aug 2020 ; itunes.com/bill  ; 7.99 ;  ;  ;  ; 97.77; Shopping; 
17 Aug 2020 ; Gpv Benahavis FX Rate £1 = €1.0995 ; 46.47 ;  ;  EUR 51.09 ;  ; 105.76; Transport; 
17 Aug 2020 ; Amazon FX Rate £1 = €1.0995 ; 55.30 ;  ;  EUR 60.80 ;  ; 152.23; Shopping; 
17 Aug 2020 ; Itunes  ; 9.99 ;  ;  ;  ; 207.53; Shopping; 
16 Aug 2020 ; El Fogon De Flore FX Rate £1 = €1.0995 ; 1.37 ;  ;  EUR 1.50 ;  ; 217.52; Restaurants; 
16 Aug 2020 ; El Fogon De Flore FX Rate £1 = €1.0995 ; 1.37 ;  ;  EUR 1.50 ;  ; 218.89; Restaurants; 
16 Aug 2020 ; El Fogon De Flores FX Rate £1 = €1.0995 ; 133.69 ;  ;  EUR 147.00 ;  ; 220.26; Restaurants; 
15 Aug 2020 ; Restaurante Chinales FX Rate £1 = €1.1051 ; 45.25 ;  ;  EUR 50.00 ;  ; 353.95; Restaurants; 
15 Aug 2020 ; Reebok Hybrid FX Rate £1 = €1.1066 ; 5.43 ;  ;  EUR 6.00 ;  ; 399.20; Health; 
15 Aug 2020 ; La Bodega del Mar FX Rate £1 = €1.1073 ; 55.45 ;  ;  EUR 61.40 ;  ; 404.63; Health; 
15 Aug 2020 ; Top-Up by *8018  ;  ; 200.00 ;  ;  ; 460.08; General; 
14 Aug 2020 ; La Bodega del Mar FX Rate £1 = €1.1053 ; 5.25 ;  ;  EUR 5.80 ;  ; 260.08; Health; 
13 Aug 2020 ; Gym junkie FX Rate £1 = €1.1068 ; 33.43 ;  ;  EUR 37.00 ;  ; 265.33; Restaurants; 
12 Aug 2020 ; Itunes  ; 1.99 ;  ;  ;  ; 298.76; Shopping; 
11 Aug 2020 ; Reebok Hybrid FX Rate £1 = €1.1104 ; 5.41 ;  ;  EUR 6.00 ;  ; 300.75; Health; 
11 Aug 2020 ; Reebok Hybrid FX Rate £1 = €1.1095 ; 90.13 ;  ;  EUR 100.00 ;  ; 306.16; Health; 
10 Aug 2020 ; The Box Market FX Rate £1 = €1.1018 ; 7.27 ;  ;  EUR 8.00 ;  ; 396.29; Restaurants; 
10 Aug 2020 ; McDonald's Puerto Banús FX Rate £1 = €1.1018 ; 3.45 ;  ;  EUR 3.80 ;  ; 403.56; Restaurants; 
10 Aug 2020 ; Parking Gourmet FX Rate £1 = €1.1018 ; 4.50 ;  ;  EUR 4.95 ;  ; 407.01; Transport; 
10 Aug 2020 ; Itunes  ; 9.99 ;  ;  ;  ; 411.51; Shopping; 
10 Aug 2020 ; H&M FX Rate £1 = €1.1018 ; 207.70 ;  ;  EUR 228.84 ;  ; 421.50; Shopping; 
10 Aug 2020 ; Gpv Benahavis FX Rate £1 = €1.1018 ; 15.86 ;  ;  EUR 17.47 ;  ; 629.20; Transport; 
10 Aug 2020 ; Top-Up by *8018  ;  ; 200.00 ;  ;  ; 645.06; General; 
10 Aug 2020 ; Gpv Benahavis FX Rate £1 = €1.1018 ; 2.73 ;  ;  EUR 3.00 ;  ; 445.06; Transport; 
10 Aug 2020 ; Amazon Prime  ; 7.99 ;  ;  ;  ; 447.79; Shopping; 
10 Aug 2020 ; Amazon FX Rate £1 = €1.1018 ; 85.99 ;  ;  EUR 94.74 ;  ; 455.78; Shopping; 
9 Aug 2020 ; Amazon FX Rate £1 = €1.1056 ; 9.22 ;  ;  EUR 10.19 ;  ; 541.77; Shopping; 
8 Aug 2020 ; Top-Up by *8018  ;  ; 300.00 ;  ;  ; 550.99; General; 
8 Aug 2020 ; Braille Skateboarding FX Rate £1 = $1.3140 ; 29.45 ;  ;  USD 38.69 ;  ; 250.99; Shopping; 
8 Aug 2020 ; Top-Up by *8018  ;  ; 200.00 ;  ;  ; 280.44; General; 
7 Aug 2020 ; Uber   *trip FX Rate £1 = €1.1055 ; 12.52 ;  ;  EUR 13.84 ;  ; 80.44; Transport; 
6 Aug 2020 ; Itunes  ; 5.99 ;  ;  ;  ; 92.96; Shopping; 
5 Aug 2020 ; Reebok Hybrid FX Rate £1 = €1.1079 ; 5.42 ;  ;  EUR 6.00 ;  ; 98.95; Health; 
5 Aug 2020 ; La Bodega del Mar FX Rate £1 = €1.1062 ; 37.83 ;  ;  EUR 41.85 ;  ; 104.37; Health; 
4 Aug 2020 ; Cash at Enes3667 FX Rate £1 = €1.1107 ; 93.59 ;  ;  EUR 103.95 ;  ; 142.20; Cash; 
4 Aug 2020 ; Autopista del Sol FX Rate £1 = €1.1112 ; 3.02 ;  ;  EUR 3.35 ;  ; 235.79; Transport; 
4 Aug 2020 ; Autopista del Sol FX Rate £1 = €1.1102 ; 3.02 ;  ;  EUR 3.35 ;  ; 238.81; Transport; 
3 Aug 2020 ; Sonora Dreams FX Rate £1 = €1.1045 ; 11.77 ;  ;  EUR 13.00 ;  ; 241.83; Restaurants; 
3 Aug 2020 ; E.s. Estepona campsa FX Rate £1 = €1.1045 ; 41.27 ;  ;  EUR 45.58 ;  ; 253.60; Transport; 
2 Aug 2020 ; Reebok Hybrid FX Rate £1 = €1.1067 ; 5.43 ;  ;  EUR 6.00 ;  ; 294.87; Health; 
30 Jul 2020 ; Maui FX Rate £1 = €1.1013 ; 301.44 ;  ;  EUR 332.00 ;  ; 300.30; Shopping; 
30 Jul 2020 ; Audible Ltd  ; 7.99 ;  ;  ;  ; 601.74; Shopping; 
29 Jul 2020 ; Top-Up by *8018  ;  ; 450.00 ;  ;  ; 609.73; General; 
29 Jul 2020 ; Reebok Hybrid FX Rate £1 = €1.0987 ; 5.47 ;  ;  EUR 6.00 ;  ; 159.73; Health; 
27 Jul 2020 ; Andy's Beach Bar FX Rate £1 = €1.0920 ; 42.13 ;  ;  EUR 46.00 ;  ; 165.20; Restaurants; 
27 Jul 2020 ; Aldi FX Rate £1 = €1.0920 ; 98.67 ;  ;  EUR 107.74 ;  ; 207.33; Groceries; 
27 Jul 2020 ; Ladys Bar FX Rate £1 = €1.0920 ; 7.79 ;  ;  EUR 8.50 ;  ; 306.00; Restaurants; 
27 Jul 2020 ; Juguettos Avda R.soria FX Rate £1 = €1.0920 ; 20.14 ;  ;  EUR 21.99 ;  ; 313.79; Shopping; 
27 Jul 2020 ; Experian Ltd  ; 14.99 ;  ;  ;  ; 333.93; General; 
27 Jul 2020 ; Bel mare FX Rate £1 = €1.0920 ; 45.79 ;  ;  EUR 50.00 ;  ; 348.92; Restaurants; 
27 Jul 2020 ; Amazon FX Rate £1 = €1.0985 ; 27.27 ;  ;  EUR 29.95 ;  ; 394.71; Shopping; 
27 Jul 2020 ; Parking Cabopino FX Rate £1 = €1.0920 ; 8.06 ;  ;  EUR 8.80 ;  ; 421.98; Transport; 
27 Jul 2020 ; Three  ; 20.00 ;  ;  ;  ; 430.04; Services; 
26 Jul 2020 ; sanebox Inc. FX Rate £1 = $1.2728 ; 1.58 ;  ;  USD 2.00 ;  ; 450.04; Shopping; 
26 Jul 2020 ; Gpv Benahavis FX Rate £1 = €1.0986 ; 8.20 ;  ;  EUR 9.00 ;  ; 451.62; Transport; 
26 Jul 2020 ; Autopista del Sol FX Rate £1 = €1.0999 ; 3.05 ;  ;  EUR 3.35 ;  ; 459.82; Transport; 
25 Jul 2020 ; Top-Up by *8018  ;  ; 150.00 ;  ;  ; 462.87; General; 
25 Jul 2020 ; Top-Up by *8018  ;  ; 150.00 ;  ;  ; 312.87; General; 
24 Jul 2020 ; Toy Planet Gral.lopez FX Rate £1 = €1.0975 ; 16.39 ;  ;  EUR 17.98 ;  ; 162.87; Shopping; 
24 Jul 2020 ; Sonora Dreams FX Rate £1 = €1.0980 ; 21.41 ;  ;  EUR 23.50 ;  ; 179.26; Restaurants; 
24 Jul 2020 ; Indigo - Avda del Mar. FX Rate £1 = €1.0980 ; 6.11 ;  ;  EUR 6.70 ;  ; 200.67; Transport; 
23 Jul 2020 ; Top-Up by *8018  ;  ; 200.00 ;  ;  ; 206.78; General; 
23 Jul 2020 ; Restaurante Dos Mares FX Rate £1 = €1.0985 ; 3.65 ;  ;  EUR 4.00 ;  ; 6.78; Restaurants; 
23 Jul 2020 ; Restaurante Dos Mares FX Rate £1 = €1.0999 ; 36.37 ;  ;  EUR 40.00 ;  ; 10.43; Restaurants; 
23 Jul 2020 ; Andreas Brunch FX Rate £1 = €1.0978 ; 29.15 ;  ;  EUR 32.00 ;  ; 46.80; Groceries; 
22 Jul 2020 ; El Corte Ingles Marbel FX Rate £1 = €1.1078 ; 15.17 ;  ;  EUR 16.80 ;  ; 75.95; Shopping; 
22 Jul 2020 ; Parking FX Rate £1 = €1.1096 ; 7.62 ;  ;  EUR 8.45 ;  ; 91.12; Transport; 
22 Jul 2020 ; Bioparc Fuengirola FX Rate £1 = €1.1104 ; 4.24 ;  ;  EUR 4.70 ;  ; 98.74; Health; 
21 Jul 2020 ; delish Marbella FX Rate £1 = €1.1063 ; 37.45 ;  ;  EUR 41.43 ;  ; 102.98; Restaurants; 
21 Jul 2020 ; Itunes  ; 3.99 ;  ;  ;  ; 140.43; Shopping; 
21 Jul 2020 ; Itunes  ; 3.99 ;  ;  ;  ; 144.42; Shopping; 
20 Jul 2020 ; Jugarnia S.l -sotogran FX Rate £1 = €1.0932 ; 9.15 ;  ;  EUR 10.00 ;  ; 148.41; Transport; 
20 Jul 2020 ; Amazon FX Rate £1 = €1.0987 ; 21.78 ;  ;  EUR 23.93 ;  ; 157.56; Shopping; 
20 Jul 2020 ; New Capital 2000 Sl FX Rate £1 = €1.0932 ; 8.05 ;  ;  EUR 8.80 ;  ; 179.34; Transport; 
20 Jul 2020 ; Gpv Benahavis FX Rate £1 = €1.0932 ; 41.17 ;  ;  EUR 45.00 ;  ; 187.39; Transport; 
20 Jul 2020 ; Itunes  ; 0.79 ;  ;  ;  ; 228.56; Shopping; 
20 Jul 2020 ; Itunes  ; 16.50 ;  ;  ;  ; 229.35; Shopping; 
19 Jul 2020 ; Amazon FX Rate £1 = €1.1043 ; 15.48 ;  ;  EUR 17.09 ;  ; 245.85; Shopping; 
19 Jul 2020 ; Reebok Hybrid FX Rate £1 = €1.0982 ; 5.47 ;  ;  EUR 6.00 ;  ; 261.33; Health; 
18 Jul 2020 ; Top-Up by *8018  ;  ; 200.00 ;  ;  ; 266.80; General; 
16 Jul 2020 ; Gym junkie FX Rate £1 = €1.1029 ; 36.27 ;  ;  EUR 40.00 ;  ; 66.80; Restaurants; 
15 Jul 2020 ; Reebok Hybrid FX Rate £1 = €1.1027 ; 5.45 ;  ;  EUR 6.00 ;  ; 103.07; Health; 
14 Jul 2020 ; Isola Press  ; 38.00 ;  ;  ;  ; 108.52; Shopping; 
14 Jul 2020 ; Chiropractic - Ricardo FX Rate £1 = €1.1126 ; 35.95 ;  ;  EUR 40.00 ;  ; 146.52; Health; 
13 Jul 2020 ; Mgyk Lumiere FX Rate £1 = €1.1104 ; 33.33 ;  ;  EUR 37.00 ;  ; 182.47; Services; 
13 Jul 2020 ; Migos House FX Rate £1 = €1.1104 ; 11.71 ;  ;  EUR 13.00 ;  ; 215.80; Restaurants; 
13 Jul 2020 ; Hustle N Flow Eatery FX Rate £1 = €1.1104 ; 63.04 ;  ;  EUR 70.00 ;  ; 227.51; Restaurants; 
13 Jul 2020 ; Taxi 97 FX Rate £1 = €1.1104 ; 23.34 ;  ;  EUR 25.91 ;  ; 290.55; Transport; 
13 Jul 2020 ; Casanis Bistrot FX Rate £1 = €1.1104 ; 117.98 ;  ;  EUR 131.00 ;  ; 313.89; Restaurants; 
13 Jul 2020 ; Itunes  ; 7.99 ;  ;  ;  ; 431.87; Shopping; 
13 Jul 2020 ; Uber   *trip FX Rate £1 = €1.1104 ; 27.53 ;  ;  EUR 30.55 ;  ; 439.86; Transport; 
13 Jul 2020 ; Amazon FX Rate £1 = €1.1104 ; 15.31 ;  ;  EUR 16.99 ;  ; 467.39; Shopping; 
12 Jul 2020 ; Reebok Hybrid FX Rate £1 = €1.1154 ; 5.38 ;  ;  EUR 6.00 ;  ; 482.70; Health; 
12 Jul 2020 ; Amazon  ; 34.47 ;  ;  ;  ; 488.08; Shopping; 
12 Jul 2020 ; Top-Up by *8018  ;  ; 200.00 ;  ;  ; 522.55; General; 
9 Jul 2020 ; Gym junkie FX Rate £1 = €1.1107 ; 35.12 ;  ;  EUR 39.00 ;  ; 322.55; Restaurants; 
9 Jul 2020 ; Amazon Prime  ; 7.99 ;  ;  ;  ; 357.67; Shopping; 
9 Jul 2020 ; Amazon FX Rate £1 = €1.1090 ; 15.29 ;  ;  EUR 16.95 ;  ; 365.66; Shopping; 
8 Jul 2020 ; Amazon FX Rate £1 = €1.1042 ; 33.50 ;  ;  EUR 36.99 ;  ; 380.95; Shopping; 
7 Jul 2020 ; Reebok Hybrid FX Rate £1 = €1.1055 ; 6.79 ;  ;  EUR 7.50 ;  ; 414.45; Health; 
6 Jul 2020 ; Top-Up by *8018  ;  ; 400.00 ;  ;  ; 421.24; General; 
6 Jul 2020 ; Detalles Marbella Sl FX Rate £1 = €1.1031 ; 1.09 ;  ;  EUR 1.20 ;  ; 21.24; Shopping; 
6 Jul 2020 ; Itunes  ; 5.99 ;  ;  ;  ; 22.33; Shopping; 
5 Jul 2020 ; Reebok Hybrid FX Rate £1 = €1.1081 ; 5.42 ;  ;  EUR 6.00 ;  ; 28.32; Health; 
3 Jul 2020 ; Gym junkie FX Rate £1 = €1.1078 ; 40.63 ;  ;  EUR 45.00 ;  ; 83.37; Restaurants; 
3 Jul 2020 ; Amazon  ; 22.05 ;  ;  ;  ; 124.00; General; 
